事件头指令：
    当开始运行(callback: () => void)：程序启动时触发。
    当触发事件(eventType: '点击' | '按下' | '放开', target: '自己' | '屏幕' | string, callback: () => void)：当指定事件类型发生在指定目标上时触发。
    当滑动屏幕(direction: '向上' | '向下' | '向左' | '向右')：当用户在指定方向上滑动屏幕时触发。
    当键盘触发(keyAction: '按下' | '放开', key: string | number | '任意键' | '回车键' | '空格键' | '←' | '↑' | '→' | '↓', callback: () => void)：当用户按下或放开键盘上的指定键时触发。
    当碰撞发生(state: '开始' | '持续' | '结束', callback: (角色属性: (name: '属性', property: 'x坐标' | 'y坐标' | '造型编号' | '阵营' | '克隆体编号' | '大小' | '宽度' | '高度' | '面向角度' | '颜色' | '透明' | '亮度' | '像素化' | '波纹' | '扭曲' | '黑白') => any) => void)：当角色与其他对象发生碰撞时触发。
    当条件满足时触发(condition: string, callback: () => void)：当指定的条件满足时触发。
    当收到广播(message: string, callback: () => void)：当程序收到指定的广播消息时触发。
    当收到广播带参数(message: string, callback: (content: string) => void)：当程序收到指定的广播消息并带有参数时触发。
    当克隆体启动(callback: () => void)：当角色的克隆体启动时触发。
循环语法指令：
    永远循环(callback: () => void)：无限循环执行回调函数。
    重复循环(times: number, callback: () => void)：重复执行回调函数指定的次数。
    遍历循环(start: number, end: number, step: number, callback: (value: number) => void)：按照指定的起始值、结束值和步长遍历执行回调函数。
    重复直到(condition: boolean, callback: () => void)：重复执行回调函数，直到指定的条件为真。
广播相关：
    发送广播(text: string)：向所有角色发送指定的广播消息。
    发送广播并等待(text: string)：发送广播消息并暂停当前脚本，直到所有接收脚本执行完毕。
    发送广播带参数(text: string, content: string)：发送带有附加内容的广播消息。
    判断是否收到广播(text: string)：检查是否收到过指定的广播消息。
屏幕切换：
    切换到屏幕(screen: number | '上一屏' | '下一屏')：切换当前显示的屏幕界面。
    设置切屏特效(direction: '向上' | '向下' | '向左' | '向右', style: '移入' | '弹入')：设置屏幕切换时的过渡动画效果。
克隆相关：
    克隆(target: '自己' | number)：创建指定目标的克隆体。
    删除本克隆体()：删除当前执行的克隆体。
    当前克隆体编号()：获取当前克隆体的唯一编号。
    克隆体总数(who: '自己' | string)：获取指定角色的克隆体数量。
    克隆体属性(who: '自己' | string, index: number, property: 'x坐标' | 'y坐标' | '造型编号' | '阵营' | '克隆体编号' | '大小' | '宽度' | '高度' | '面向角度' | '颜色' | '透明' | '亮度' | '像素化' | '波纹' | '扭曲' | '黑白')：获取指定克隆体的属性值。
控制流：
    重启()：重启整个应用程序。
    停止脚本(script: '全部脚本' | '当前脚本' | '当前角色其他脚本' | '其他角色脚本')：停止指定范围的脚本执行。
    等待秒数(seconds: number)：暂停指定秒数后继续执行。
    打印(text: string)：输出指定的文本内容。
    等待直到(condition: boolean)：暂停执行，直到指定的条件为真。
    退出循环()：立即退出当前循环。
角色移动：
    移动步数(steps: number)：向当前方向移动指定的步数。
    移动到(target: '鼠标' | '随机' | string)：将角色移动到指定的目标位置。
    设置碰到边缘反弹()：设置角色在碰到舞台边缘时自动反弹。
    移到位置(x: number, y: number)：将角色移动到指定的坐标位置。
    设置x坐标(x: number)：设置角色的x坐标。
    设置y坐标(y: number)：设置角色的y坐标。
    改变x坐标(operation: '增加' | '减少', amount: number)：根据操作类型增加或减少角色的x坐标。
    改变y坐标(operation: '增加' | '减少', amount: number)：根据操作类型增加或减少角色的y坐标。
    逐渐移动(seconds: number, x: number, y: number)：在指定时间内将角色逐渐移动到目标坐标。
    逐渐改变x坐标(seconds: number, operation: '增加' | '减少', amount: number)：在指定时间内逐渐增加或减少角色的x坐标。
    逐渐改变y坐标(seconds: number, operation: '增加' | '减少', amount: number)：在指定时间内逐渐增加或减少角色的y坐标。
角色旋转：
    旋转角度(angle: number)：设置角色的旋转角度。
    围绕角色旋转(character: string, angle: number)：使角色围绕指定角色旋转一定角度。
    设置旋转模式(mode: '自由旋转' | '左右旋转' | '不旋转')：设置角色的旋转模式。
    设置面向角度(angle: number)：设置角色的面向角度。
    设置面向对象(target: '鼠标' | '随机' | string)：设置角色面向指定的目标。
角色状态：
    设置角色拖动(mode: '可拖动' | '不可拖动')：设置角色是否可以被拖动。
    设置角色阵营(faction: '红色阵营' | '绿色阵营' | '蓝色阵营' | '无阵营')：设置角色的阵营。
    设置造型(index: number)：设置角色为指定的造型。
    切换造型(direction: '上一个' | '下一个')：切换角色的造型到上一个或下一个。
    设置角色状态(state: '显示' | '隐藏')：设置角色的显示或隐藏状态。
    逐渐改变角色状态(seconds: number, state: '逐渐显示' | '逐渐隐藏')：在指定时间内逐渐显示或隐藏角色。
    设置角色大小(size: number)：设置角色的大小。
    改变角色大小(action: '增加' | '减少', amount: number)：根据操作类型增加或减少角色的大小。
    设置角色宽高(dimension: '宽度' | '高度', value: number)：设置角色的宽度或高度。
    改变角色宽高(dimension: '宽度' | '高度', action: '增加' | '减少', amount: number)：根据操作类型增加或减少角色的宽度或高度。
特效：
    设置特效(effect: '颜色' | '透明' | '亮度' | '像素化' | '波纹' | '扭曲' | '黑白', value: number)：为角色设置指定的特效。
    改变特效(effect: '颜色' | '透明' | '亮度' | '像素化' | '波纹' | '扭曲' | '黑白', action: '增加' | '减少', amount: number)：根据操作类型增加或减少角色的特效值。
    清除特效()：清除角色上的所有特效。
    移动角色图层(target: '最上层' | '最下层' | '上一层' | '下一层' | number)：将角色移动到指定的图层位置。
    设置强调特效(effect: '抖动' | '缩放' | '跳跃')：为角色设置指定的强调特效。
    设置入场特效(entrance: '出现' | '消失', direction: '从上' | '从下' | '从左' | '从右', style: '掉落' | '弹入' | '飞入')：为角色设置指定的入场特效。
    设置全局特效(effect: '礼炮' | '烟花' | '尴尬' | '无语')：为舞台设置指定的全局特效。
    将角色变为文字(text: string)：将角色替换为指定的文字。
    设置文字字号(size: number)：设置文字的字号大小。
    设置文字颜色(color: string)：设置文字的颜色。
对话框：
    弹出对话框(character: '自己' | number, text: string)：显示一个带有指定角色和文本内容的对话框。
    弹出提示(type: '对话' | '思考', text: string)：显示一个指定类型的提示框，内容为文本。
    弹出提示指定秒数(type: '对话' | '思考', text: string, seconds: number)：显示一个指定类型的提示框，内容为文本，并在指定秒数后自动关闭。
    弹出输入框(promptText: string)：显示一个输入框，提示用户输入内容。
    输入框结果()：获取用户通过输入框输入的内容。
    弹出选择框(promptText: string, ...args: string[])：显示一个选择框，提示用户从多个选项中选择一个。
    选择框结果()：获取用户通过选择框选择的选项。
    弹出翻译弹窗(text: string, language: '英文' | '中文' | '文言文' | '法语' | '西班牙语' | '日语')：显示一个翻译弹窗，将指定文本翻译为目标语言。
    翻译结果(text: string, language: '英文' | '中文' | '文言文' | '法语' | '西班牙语' | '日语')：将指定文本翻译为目标语言并返回翻译结果。
声音：
    播放声音(sound: string)：播放指定的声音。
    播放声音直到结束(sound: string)：播放指定的声音，并等待声音播放完毕。
    停止声音(sound: '全部声音' | string)：停止指定的声音或所有声音的播放。
    播放文本(text: string)：将指定文本转换为语音并播放。
    播放文本直到结束(text: string)：将指定文本转换为语音并播放，等待播放完毕。
    弹出语音识别弹窗(language: '中文' | '英文')：显示一个语音识别弹窗，识别用户输入的语音。
    语音识别结果()：获取用户通过语音识别弹窗输入的语音内容。
画笔：
    落笔()：开始绘制画笔轨迹。
    抬笔()：停止绘制画笔轨迹。
    清除画笔()：清除所有画笔绘制的轨迹。
    设置画笔粗细(size: number)：设置画笔的粗细大小。
    改变画笔粗细(action: '增加' | '减少', amount: number)：增加或减少画笔的粗细。
    设置画笔颜色(color: string)：设置画笔的颜色。
    设置画笔特效(effect: '颜色值' | '饱和度' | '亮度' | '透明度', value: number)：设置画笔的特效属性。
    改变画笔特效(action: '增加' | '减少', effect: '颜色值' | '饱和度' | '亮度' | '透明度', amount: number)：增加或减少画笔的特效属性。
    设置图像印章()：将当前图像设置为印章。
    设置文字印章(text: string, fontSize: number, alignment: '居中' | '居左' | '居右')：设置文字印章的内容、字号和对齐方式。
    移动画笔图层(target: '最上层' | '最下层' | '上一层' | '下一层' | number)：将画笔图层移动到指定位置。
数学运算：
    随机整数(leftBoundary: number, rightBoundary: number)：生成指定范围内的随机整数。
    舍入运算(mode: '四舍五入' | '向上舍入' | '向下舍入', number: number)：对指定数字进行舍入运算。
    余数运算(dividend: number, divisor: number)：计算两个数相除的余数。
    整除判断(dividend: number, divisor: number)：判断两个数是否整除。
    数值判断(number: number, type: '质数' | '合数' | '偶数' | '奇数' | '整数' | '正数' | '负数')：判断数字的类型。
    三角函数(func: 'sin' | 'cos' | 'tan' | 'asin' | 'acos' | 'atan', number: number)：计算指定三角函数的数值。
    科学计算(operation: '算数平方根' | '绝对值' | '-' | 'ln' | 'log10' | 'e^' | '10^', number: number)：执行指定的科学计算操作。
字符串操作：
    连接字符串(...arg: string[])：将多个字符串连接成一个字符串。
    分开字符串(str: string, delimiter: string)：将字符串按指定分隔符分割成数组。
    字符串包含判断(str: string, substr: string)：判断字符串是否包含指定的子字符串。
    选择字符串(str: string, startIndex: number, endIndex: number)：从字符串中截取指定范围的子字符串。
    字符串长度(str: string)：获取字符串的长度。
    类型转换(value: string, targetType: '字符串' | '数值' | '布尔')：将值转换为指定的类型。
碰撞检测：
    判断角色碰撞(subject: '自己' | string | '红色阵营' | '绿色阵营' | '蓝色阵营', object: '自己' | string | '鼠标' | '边缘' | '上边缘' | '下边缘' | '左边缘' | '右边缘' | '红色阵营' | '绿色阵营' | '蓝色阵营')：判断指定角色是否与目标对象发生碰撞。
    判断颜色碰撞(subject: '自己' | string | '红色阵营' | '绿色阵营' | '蓝色阵营', color: string)：判断指定角色是否与指定颜色发生碰撞。
    判断离开边缘(edge: '边缘' | '上边缘' | '下边缘' | '左边缘' | '右边缘')：判断角色是否离开指定的舞台边缘。
角色属性获取：
    角色坐标(who: '自己' | string, coordinate: 'x坐标' | 'y坐标')：获取指定角色的坐标值。
    造型编号(who: '自己' | string)：获取指定角色的当前造型编号。
    角色属性值(who: '自己' | string, attribute: '大小' | '宽度' | '高度' | '面向角度')：获取指定角色的属性值。
    角色特效值(who: '自己' | string, effect: '颜色' | '透明' | '亮度' | '像素化' | '波纹' | '扭曲' | '黑白')：获取指定角色的特效值。
    到对象的距离(target: string | '鼠标')：计算角色到指定对象的距离。
    侦测触发值(event: '点击' | '按下' | '放开', target: '自己' | '屏幕' | string)：判断指定事件是否在目标上触发。
    侦测键盘值(event: '按下' | '放开', key: string | number | '任意键' | '回车键' | '空格键' | '←' | '↑' | '→' | '↓')：判断指定键盘事件是否触发。
    鼠标坐标(coordinate: 'x坐标' | 'y坐标')：获取鼠标的坐标值。
    手机倾斜值(component: 'X分量' | 'Y分量' | 'Z分量')：获取手机的倾斜分量值。
    麦克风音量()：获取当前麦克风的音量值。
    当前时间(part: '年' | '月' | '日' | '小时' | '分钟' | '秒')：获取当前时间的指定部分。
    执行计时器(action: '开始' | '停止' | '重置')：执行计时器的指定操作。
    设置计时器状态(state: '显示' | '隐藏')：设置计时器的显示或隐藏状态。
    计时器值()：获取当前计时器的值。
    舞台属性(attribute: '宽度' | '高度')：获取舞台的指定属性值。
变量操作：
    改变变量(name: string, action: '增加' | '减少', value: number)：增加或减少指定变量的值。
    设置变量状态(state: '显示' | '隐藏', name: string)：设置变量的显示或隐藏状态。
    定义脚本变量(...args: string[])：定义一个或多个脚本变量。
    设置列表状态(state: '显示' | '隐藏', listName: string)：设置列表的显示或隐藏状态。